-17 12 -10 10
000000000000000000000000000000
111111100000000000000000000000
111111100000000000000000000000
111111100000000000000000000000
111111110000000000000000000000
111111100000000000000000000000
111111100000000000000111111100
111111100000000000000111111100
000000000000000000000111111100
000000000000000100000111111110
000000000000000000000111111100
000000000000000000000111111100
000000000000000000000111111100
000000000000000000000000000000
000000111111100000000000000000
000001111111100000000000000000
000000111111100000000000000000
000000111111100000000000000000
000000111111100000000000000000
000000111111100000000000000000
000000111111100000000000000000
