-17
17
-10
10
1111111000000000000000000000000000
1111111000000000000000000000000000
1111111000000000000000000000000000
1111111100000000000000000000000000
1111111000000000000000000000000000
1111111000000000000001111111000000
1111111000000000000001111111000000
0000000000000000000001111111000000
0000000000000001000001111111100000
0000000000000000000001111111000000
0000000000000000000001111111000000
0000000000000000000001111111000000
0000000000000000000000000000000000
0000001111111000000000000000000000
0000011111111000000000000000000000
0000001111111000000000000000000000
0000001111111000000000000000000000
0000001111111000000000000000000000
0000001111111000000000000000000000
0000001111111000000000000000000000
